10.ox
.oooo..ooo
o.o...o.o.
oo.o.....o
....oo....
...o......
....o.....
..........
....o....o
.........o
oo.o.o..o.
